# symbolfont_dict.txt
#
# 形式: フォント名.キャラクター<TAB>置換後文字列
# 例:
#   Wingdings.a	■
#   Wingdings.b	▲
#
# メモ:
# - フォント名は大小/空白/アンダースコア差を吸収して照合されます。
# - 置換後文字列には翻訳拒否タグ等を含めてもOK（翻訳側で扱う想定）。

GloranthaCoreRunes-Regul.1	[Ф1]
GloranthaCoreRunes-Regul.2	[Ф2]
GloranthaCoreRunes-Regul.3	[Ф3]
GloranthaCoreRunes-Regul.4	[Ф4]
GloranthaCoreRunes-Regul.5	[Ф5]
GloranthaCoreRunes-Regul.6	[Ф6]
GloranthaCoreRunes-Regul.7	[Ф7]
GloranthaCoreRunes-Regul.w	[Water]
GloranthaCoreRunes-Regul.e	[Earth]
GloranthaCoreRunes-Regul.t	[Death]
GloranthaCoreRunes-Regul.y	[Truth]
GloranthaCoreRunes-Regul.u	[Undead]
GloranthaCoreRunes-Regul.i	[Illusion]
GloranthaCoreRunes-Regul.o	[Darkness]
GloranthaCoreRunes-Regul.p	[Plant]
GloranthaCoreRunes-Regul.a	[Law]
GloranthaCoreRunes-Regul.s	[Movement]
GloranthaCoreRunes-Regul.d	[Dragon]
GloranthaCoreRunes-Regul.f	[Lightbringers]
GloranthaCoreRunes-Regul.g	[Air]
GloranthaCoreRunes-Regul.h	[Communication]
GloranthaCoreRunes-Regul.j	[Disorder]
GloranthaCoreRunes-Regul.k	[Shargash]
GloranthaCoreRunes-Regul.l	[Harmony]
GloranthaCoreRunes-Regul.x	[Fertility]
GloranthaCoreRunes-Regul.c	[Stasis]
GloranthaCoreRunes-Regul.b	[Spirit]
GloranthaCoreRunes-Regul.n	[Horse]
GloranthaCoreRunes-Regul.,	[Man]
GloranthaCoreRunes-Regul..	[Fire/Sky]
GloranthaCoreRunes-Regul./	[Moon]
GloranthaCoreRunes-Regul.Q	[Cold]
GloranthaCoreRunes-Regul.W	[Mastery]
GloranthaCoreRunes-Regul.E	[Heler]
GloranthaCoreRunes-Regul.R	[Magic]
GloranthaCoreRunes-Regul.Y	[Yinkin]
GloranthaCoreRunes-Regul.I	[God / Divine World]
GloranthaCoreRunes-Regul.O	[Light]
GloranthaCoreRunes-Regul.P	[Pamalt]
GloranthaCoreRunes-Regul.A	[Dragonewt]
GloranthaCoreRunes-Regul.S	[Infinity]
GloranthaCoreRunes-Regul.F	[Barntar]
GloranthaCoreRunes-Regul.G	[Sartar]
GloranthaCoreRunes-Regul.H	[Hell]
GloranthaCoreRunes-Regul.K	[Luck]
GloranthaCoreRunes-Regul.L	[Heat]
GloranthaCoreRunes-Regul.X	[Fate]
GloranthaCoreRunes-Regul.C	[Bear]
GloranthaCoreRunes-Regul.V	[Eternal Battle]
GloranthaCoreRunes-Regul.B	[Beast]
GloranthaCoreRunes-Regul.?	[Chaos]

GloranthaRuneIcons-Regul.1	[Ф1]
GloranthaRuneIcons-Regul.2	[Ф2]
GloranthaRuneIcons-Regul.3	[Ф3]
GloranthaRuneIcons-Regul.4	[Ф4]
GloranthaRuneIcons-Regul.5	[Ф5]
GloranthaRuneIcons-Regul.6	[Ф6]
GloranthaRuneIcons-Regul.7	[Ф7]
GloranthaRuneIcons-Regul.w	[Water]
GloranthaRuneIcons-Regul.e	[Earth]
GloranthaRuneIcons-Regul.t	[Death]
GloranthaRuneIcons-Regul.y	[Truth]
GloranthaRuneIcons-Regul.u	[Undead]
GloranthaRuneIcons-Regul.i	[Illusion]
GloranthaRuneIcons-Regul.o	[Darkness]
GloranthaRuneIcons-Regul.p	[Plant]
GloranthaRuneIcons-Regul.a	[Law]
GloranthaRuneIcons-Regul.s	[Movement]
GloranthaRuneIcons-Regul.d	[Dragon]
GloranthaRuneIcons-Regul.f	[Lightbringers]
GloranthaRuneIcons-Regul.g	[Air]
GloranthaRuneIcons-Regul.h	[Communication]
GloranthaRuneIcons-Regul.j	[Disorder]
GloranthaRuneIcons-Regul.k	[Shargash]
GloranthaRuneIcons-Regul.l	[Harmony]
GloranthaRuneIcons-Regul.x	[Fertility]
GloranthaRuneIcons-Regul.c	[Stasis]
GloranthaRuneIcons-Regul.b	[Spirit]
GloranthaRuneIcons-Regul.n	[Horse]
GloranthaRuneIcons-Regul.,	[Man]
GloranthaRuneIcons-Regul..	[Fire/Sky]
GloranthaRuneIcons-Regul./	[Moon]
GloranthaRuneIcons-Regul.Q	[Cold]
GloranthaRuneIcons-Regul.W	[Mastery]
GloranthaRuneIcons-Regul.E	[Heler]
GloranthaRuneIcons-Regul.R	[Magic]
GloranthaRuneIcons-Regul.Y	[Yinkin]
GloranthaRuneIcons-Regul.I	[God / Divine World]
GloranthaRuneIcons-Regul.O	[Light]
GloranthaRuneIcons-Regul.P	[Pamalt]
GloranthaRuneIcons-Regul.A	[Dragonewt]
GloranthaRuneIcons-Regul.S	[Infinity]
GloranthaRuneIcons-Regul.F	[Barntar]
GloranthaRuneIcons-Regul.G	[Sartar]
GloranthaRuneIcons-Regul.H	[Hell]
GloranthaRuneIcons-Regul.K	[Luck]
GloranthaRuneIcons-Regul.L	[Heat]
GloranthaRuneIcons-Regul.X	[Fate]
GloranthaRuneIcons-Regul.C	[Bear]
GloranthaRuneIcons-Regul.V	[Eternal Battle]
GloranthaRuneIcons-Regul.B	[Beast]
GloranthaRuneIcons-Regul.?	[Chaos]